B,B,B,B,B,B,B,B,B,B,B,B,B,B,B,B,B,B,B,B,B,B,B,B,B
B, , , , , , , , , , , , , , , , , , , , , , , ,B
B, , , , , , , , , , , , , , , , , , , , , , , ,B
B, , , , , , , , , , , , , , , , , , , , , , , ,B
B, , , , , , , , , , , , , , , , , , , , , , , ,B
B, , , , , , , , , , , , , , , , , , , , , , , ,B
B, , , , , , , , , , , , , , , , , , , , , , , ,B
B, , ,E, , , , , , , , , , , , , , , , , , , , ,B
B, ,B,B,B,B, , , ,C, , , , , , , , , , , , , , ,B
B, , , , , , , , ,B, , , , , , , , , , , , , , ,B
B, , , , , , , , , , , , , , , , , , , , , , , ,B
B, , , ,V, , , , , , , , , ,V, , , ,C, , , , , ,B
B, , , , , , , , , ,B, , , , , , ,B,B, , , ,C,C,B
B, , , , , , , , , , , , , , , , , , , , ,B,B,B,B
X, ,S, ,C,C, , , ,B, ,C, ,B, ,F, , ,F, ,F,B,B,B,B
B,B,B,B,B,B,B,T,T,B,B,B,B,B,B,B,T,T,T,B,B,B,B,B,B